111111111111
1100000C0001
111E000010P1
111111111111
