11111111111111111111111111111
1100000C000111111111111111111
111E0000000C00011111111111111
11111111111000000000001111111
111111111111111111111C1111111
11111111111111111111101111111
11111111111111111111101111111
11111111111100000000001111111
110000000000000000000C0011111
111111111111111111111000P1111
11111111111111111111111111111